1.Բյուջետային միջոցների չարաշահումներ:
Ֆինանսական միջոցների յուրացում: Բյուջեի միջոցների խարդախություն և յուրացում՝ պետական ծրագրերի և նախագծերի իրականացման ընթացքում:
Կեղծ հաշվետվություններ: Կեղծ հաշվետվությունների ներկայացում ֆինանսական միջոցների օգտագործման վերաբերյալ՝ նպատակ ունենալով խուսափել պատասխանատվությունից կամ ֆինանսական խախտումներ թաքցնել:
2.Պետական գնումների և մատակարարման չարաշահումներ:
Կեղծ մրցույթներ: Պետական գնումների մրցույթների արդյունքների կեղծում և պայմանագրերի տրամադրում նախընտրած ընկերություններին՝ առանց իրական մրցակցության:
Կաշառք և փոխհատուցում: Կաշառքի ընդունում պետական գնումների պայմանագրերի կնքում կամ փոփոխման համար:
3.Բյուջետային օգնության չարաշահումներ:
Անօրինական աջակցություններ: Պետական բյուջեից տրամադրվող օգնությունների (օրինակ՝ սուբսիդիաներ, դրամաշնորհներ) անօրինական տրամադրում անձնական շահերի կամ կաշառքի դիմաց:
Կաշառք և փոխհատուցում: Կաշառքի ընդունում պետական օգնությունների տրամադրման կամ փոփոխման համար:
4.Կրթական և վերապատրաստման ծրագրերի չարաշահումներ:
Կեղծ ծրագրեր: Կրթական և վերապատրաստման ծրագրերի կեղծում կամ անօրինական միջոցների օգտագործում՝ մասնակիցներին անվանական պարգևներ տալու նպատակով:
Կաշառք վերապատրաստումների համար: Կաշառքի ընդունում մասնակիցների ընտրության կամ վերապատրաստումների համար:
5.Ֆինանսական վերահսկողության պակաս:
Հաշվետվողականության բացակայություն: Ֆինանսների նախարարության աշխատանքի հաշվետվողականության և թափանցիկության բացակայություն:
Ֆինանսական հաշվետվությունների պակաս: Հաշվետվությունների ներկայացման և ստուգման գործընթացում թերություններ և թափանցիկության պակաս:
6.Պետական բյուջեի մուտքերի չարաշահումներ:
Անօրինական մուտքեր: Պետական բյուջե մուտքերի կեղծում կամ անօրինական միջոցների ներմուծում:
Կաշառք մուտքերի համար: Կաշառքի ընդունում պետական բյուջեի մուտքերի ձևավորման կամ օգտագործման համար:
7.Պետական պարտքերի կառավարման չարաշահումներ:
Կեղծ պարտքերի հաշվառում: Պետական պարտքերի կեղծ հաշվառում և չհայտարարում՝ նպատակ ունենալով թաքցնել ֆինանսական ճգնաժամերը կամ պարտքերի իրական ծավալը:
Կաշառք պարտքերի կառավարման համար: Կաշառքի ընդունում պետական պարտքերի կառավարման և պայմանագրերի կնքման համար:
8.Անօրինական ֆինանսական գործարքներ:
Անօրինական ներդրումներ: Կաշառքի կամ այլ անձնական շահերի հիման վրա իրականացվող անօրինական ներդրումներ և ֆինանսական գործարքներ:
Կեղծ ֆինանսական փաստաթղթեր: Կեղծ ֆինանսական փաստաթղթերի պատրաստում՝ հարկերից խուսափելու կամ ֆինանսական հաշվետվություններ կեղծելու նպատակով:
9.Հաշվետվությունների կեղծում:
Կեղծ հաշվետվություններ: Կեղծ հաշվետվությունների և փաստաթղթերի պատրաստում՝ ֆինանսական խախտումների կամ բյուջետային ռեսուրսների յուրացման նպատակով:
Անօրինական ֆինանսական ստուգումներ: Ֆինանսական ստուգումների կեղծում կամ անօրինական փոփոխություններ ստուգումների արդյունքում:
10.Անօրինական ֆինանսական խորհրդատվություն:
Կաշառք խորհրդատվությունների համար: Կաշառքի ընդունում ֆինանսական խորհրդատվություններ տրամադրելու կամ ֆինանսական որոշումների ընդունման համար:
Կեղծ խորհրդատվություններ: Կեղծ ֆինանսական խորհրդատվությունների տրամադրում՝ անձնական շահի կամ կաշառքի նպատակով:


